border_size=1
usage=map

Wo          , Wo          , Ww          , Ww          , Ww          , Ww          , Ww          , Ww          , Ww          , Ww          , Ww          , Ww          , Ww          , Ww          , Ww          , Ww          , Ww          , Ww          , Ww          , Ww          , Wo          , Ww          
Wo          , Ww          , Ww          , Gs^Vht      , 3 Ke        , Ce          , Gg          , Gg          , Gg          , Gg          , Gg          , Gg          , Gg          , Ww          , Ce          , Gs^Vht      , Gs^Vht      , Ww          , Ww          , Wo          , Wo          , Ww          
Wo          , Wo          , Ww          , Ce          , Ce          , Ce          , Gg          , Gg          , Gg          , Gg          , Gg          , Gg          , Gg          , Gg          , Ce          , 2 Ke        , Ce          , Ww          , Ww          , Wo          , Wo          , Wo          
Wo          , Wo          , Ww          , Gg          , Gg          , Gg          , Gg          , Gg          , Hh          , Gg          , Gg          , Gg          , Ww          , Gg          , Gg          , Ce          , Gg          , Ww          , Ww          , Wo          , Wo          , Wo          
Wo          , Wo          , Ww          , Gg          , Ww          , Ww          , Ww          , Hh          , Mm          , Hh          , Gg          , Ww          , Ww          , Ww          , Gg          , Gg          , Gg          , Ww          , Ww          , Wo          , Wo          , Wo          
Wo          , Wo          , Ww          , Gg          , Ww          , Ww          , Ww          , Hh          , Hh          , Hh          , Gg          , Ww          , Ww          , Ww          , Gs^Ft       , Gg          , Ww          , Ww          , Ww          , Wo          , Wo          , Wo          
Wo          , Wo          , Ww          , Gg          , Gg          , Ww          , Ww          , Hh          , Hh          , Gg          , Gg          , Ww          , Gs^Ft       , Gs^Ft       , Gs^Ft       , Gg          , Ww          , Ww          , Wo          , Wo          , Wo          , Wo          
Wo          , Wo          , Ww          , Gg          , Gg          , Gg          , Hh          , Hh          , Hh          , Gg          , Gg          , Gs^Ft       , Gs^Ft       , Gs^Ft       , Gg          , Ww          , Ww          , Wo          , Wo          , Wo          , Wo          , Wo          
Wo          , Wo          , Ww          , Ww          , Gg          , Gg          , Gg          , Hh          , Hh          , Hh          , Gg          , Gg          , Gg          , Gg          , Ww          , Ww          , Ww          , Wo          , Wo          , Wo          , Wo          , Wo          
Wo          , Wo          , Ww          , Ww          , Wwf         , Gg          , Gg          , Gg          , Gg          , Hh          , Gg          , Gg          , Ww          , Wwf         , Wwf         , Ww          , Ww          , Ww          , Ww          , Wo          , Wo          , Wo          
Wo          , Wo          , Ww          , Ww          , Wwf         , Ww          , Ww          , Ww          , Wwf         , Gg          , Wwf         , Ww          , Ww          , Ww          , Gg          , Gg          , Gg          , Gg          , Ww          , Ww          , Wo          , Wo          
Wo          , Wo          , Ww          , Ww          , Gg          , Ww          , Ww          , Ww          , Wwf         , 1 Wwf       , Wwf         , Ww          , Hh          , Hh          , Hh          , Gg          , Hh          , Gg          , Ww          , Ww          , Wo          , Wo          
Wo          , Wo          , Ww          , Gg          , Gg          , Gg          , Gs^Ft       , Gg          , Gg          , Gg          , Gg          , Gg          , Hh          , Mm          , Hh          , Hh          , Gg          , Ww          , Ww          , Ww          , Wo          , Wo          
Wo          , Wo          , Wo          , Ww          , Ww          , Gs^Ft       , Gs^Ft       , Gs^Ft       , Gg          , Gg          , Gg          , Gg          , Hh          , Hh          , Gg          , Gg          , Gg          , Gg          , Ww          , Ww          , Wo          , Wo          
Wo          , Wo          , Wo          , Gg          , Gs^Ft       , Gs^Ft       , Gs^Ft       , Gs^Ft       , Gg          , Gg          , Gg          , Gg          , Hh          , Gg          , Gg          , Gg          , Ww          , Ww          , Ww          , Ww          , Wo          , Wo          
Wo          , Wo          , Wo          , Gg          , Gs^Ft       , Gs^Ft       , Gs^Ft       , Gs^Ft       , Gg          , Gg          , Gg          , Gg          , Gg          , Gg          , Gg          , Gg          , Gg          , Ww          , Ww          , Wo          , Wo          , Wo          
Wo          , Wo          , Ww          , Ww          , Ww          , Gg          , Gg          , Gg          , Gg          , Gg          , Gg          , Gg          , Gg          , Gg          , Gg          , Ww          , Ww          , Ww          , Ww          , Wo          , Wo          , Wo          
Wo          , Ww          , Ww          , Ww          , Gg          , Gg          , Gg          , Gg          , Ww          , Ww          , Ww          , Gg          , Gg          , Gg          , Gg          , Ww          , Ww          , Ww          , Ww          , Wo          , Wo          , Wo          
Wo          , Wo          , Wo          , Gg          , Ce          , Gg          , Gg          , Gg          , Ww          , Ww          , Ww          , Gg          , Gg          , Gg          , Gg          , Gg          , Gg          , Ww          , Ww          , Ww          , Wo          , Wo          
Wo          , Wo          , Wo          , Ce          , 4 Ke        , Ce          , Gg          , Gg          , Gg          , Ww          , Ww          , Gg          , Gg          , Gg          , Ce          , Ce          , Ce          , Ww          , Ww          , Ww          , Wo          , Wo          
Wo          , Wo          , Wo          , Gs^Vht      , Gs^Vht      , Ce          , Gg          , Gg          , Gg          , Ww          , Ww          , Gg          , Gg          , Gg          , Ce          , 5 Ke        , Gs^Vht      , Ww          , Ww          , Ww          , Wo          , Wo          
Ww          , Wo          , Wo          , Wo          , Ww          , Wo          , Ww          , Gg          , Gg          , Gg          , Ww          , Gg          , Ww          , Ww          , Ww          , Ww          , Ww          , Wo          , Wo          , Wo          , Wo          , Wo          
